; Основные параметры для лабиринта ( ширина, высота, x, y, начальное направление )
15 15 1.5 1.5 0

; Основная карта лабиринта - #-это стена, " "-это пустота, возможно будет что-то ещё...
## # # # # ####
#    #   #    #
### ## # #    #
#   @  # #    #
## ##### ######
   #   #       
#  #     ######
# ##   # #    #
#      # @    #
#  #@### #    #
####   # ######
   # # # #     
## # # # # ####
   # # # # @   
## # # # # ####
